wwe	wwe
engl	engl
egiptul	egypt
mori	die
amintit	remembered
moise	moses
helin	helin
încoronat	crowned
atribuit	attributed
atribuit	assigned
bulevardul	boulevard
pereche	pair
marină	navy
marină	marine
călătorit	travelled
călătorit	traveled
vechime	seniority
secuiesc	secuiesc
nokia	nokia
bucăți	chunks
bucăți	pieces
dispariția	disappearance
înlocuite	replaced
cifre	digits
cifre	figures
construiește	construct
ființe	beings
rafael	raphael
rafael	rafael
tras	pulled
implicate	involved
morală	moral
morală	morals
valois	valois
ville	ville
que	que
bin	bin
brazilian	brazilian
florile	flowers
noțiunea	notion
field	field
gimnastică	gymnastics
executarea	enforcement
executarea	execution
ieșire	output
ieșire	exit
jason	jason
angiosperme	angiosperms
legende	legends
desfășurarea	deployment
accent	accent
benin	benin
alberto	alberto
aplicate	applied
implicit	default
cairo	cairo
anime	anime
nassau	nassau
alcool	alcohol
titus	titus
remarcabile	remarkable
promova	promote
slave	slavic
moduri	ways
moduri	modes
complexă	complex
academic	academic
prelucrare	processing
nobil	noble
plătit	paid
kansas	kansas
conducătorii	rulers
marcată	marked
descoperiri	discoveries
descoperiri	discovery
fundal	background
calificare	qualifications
calificare	qualification
full	full
paralela	parallel
organele	organs
tratează	treat
tratează	treats
dispută	dispute
lazio	lazio
popoare	peoples
fișiere	files
califatul	caliphate
programele	programs
greșeli	mistakes
autonomie	autonomy
câini	dogs
pin	pine
pin	pin
predominant	predominant
predominant	predominantly
jános	jános
reparații	repair
reparații	repairs
piciorul	leg
reluat	resumed
romulus	romulus
administratori	administrators
administratori	admins
groază	horror
groază	dread
opinie	opinion
contrast	contrast
baker	baker
asasinarea	assassination
claudiu	claudiu
salzburg	salzburg
simțit	felt
server	server
aerul	air
globul	globe
lideri	leaders
lux	lux
lux	luxury
cia	cia
cia	cla
finalizat	completed
ceremonia	ceremony
roberto	roberto
extern	externally
extern	external
arii	arias
arii	areas
lumi	worlds
apostol	apostle
curge	flows
curge	flowing
tha	tha
localnici	locals
dezvăluie	disclose
dezvăluie	reveal
dezvăluie	reveals
virtual	virtual
plural	plural
găzduit	hosted
înțelegerea	understanding
echipajul	crew
dispozitive	devices
riscul	risk
asociată	associated
asociată	associate
ofensiva	offensive
nunta	wedding
jefferson	jefferson
protest	protest
minte	mind
contractul	contract
wettin	wettin
electoral	electoral
parlamentar	parliamentary
parlamentar	mp
carter	carter
agenții	agents
agenții	agencies
recunoscute	recognized
recunoscute	recognised
ariège	ariège
politehnica	politehnica
politehnica	polytechnic
frecvență	frequency
mont	mont
traversat	crossed
penal	criminal
penal	penal
ochiul	eye
colonia	colony
recomandă	recommends
recomandă	recommend
feroviar	rail
învață	learn
agenți	agents
transformată	transformed
verzi	green
marcă	brand
adoptarea	adoption
harrison	harrison
dell	dell
explicat	explained
supremă	supreme
campbell	campbell
exprimare	expression
concentrare	concentration
guvernatorul	governor
hărți	maps
minerva	minerva
fabricarea	manufacture
fabricarea	manufacturing
estimată	estimated
four	four
moara	mill
grupurile	groups
absența	absence
sărbători	holiday
sărbători	holidays
arheologie	archeology
arheologie	archaeology
băile	bathrooms
băile	baths
bord	board
armele	weapons
armele	guns
știa	knew
prizonier	prisoner
părinte	father
părinte	parent
tribunalul	tribunal
leu	lion
leu	leu
subțire	slim
subțire	thin
producătorul	manufacturer
germain	germain
invers	backwards
invers	reverse
desfășurare	deployment
capitol	chapter
gară	station
renumit	renowned
orele	hours
tablă	blackboard
tablă	tin
tablă	board
metodele	methods
harold	harold
compozitorul	composer
blindate	armored
blindate	armoured
roy	roy
teorema	theorem
brațe	arms
proceselor	processes
părul	hair
putna	putna
jon	jon
universale	universal
poduri	bridges
adaptat	adapted
brigadă	brigade
negri	blacks
provizoriu	provisional
provizoriu	provisionally
normale	normal
templu	temple
beneficiat	benefited
consumul	consumption
sandu	sandu
pcr	pcr
religii	religions
ungheni	ungheni
arsenal	arsenal
blocuri	blocks
achiziționat	acquired
achiziționat	purchased
oana	oana
executate	executed
treizeci	thirty
suburbie	suburb
suburbie	suburbia
preferă	prefers
preferă	prefer
proprietarul	owner
nobili	nobles
nobili	noble
forțată	forced
ducat	duchy
metropolitan	metropolitan
scuze	sorry
iubirea	love
ann	ann
talent	talent
salvador	salvador
cultul	cult
low	low
santo	santo
grammy	grammy
nucleul	core
astronomie	astronomy
metalice	metallic
philadelphia	philadelphia
molotov	molotov
sony	sony
feminină	feminine
focșani	focșani
gură	mouth
plăci	plates
plăci	tiles
psihologie	psychology
creator	creator
circuit	circuit
neutru	neutral
bahia	bahia
topografice	topographical
telefon	phone
telefon	telephone
controlată	controlled
benedict	benedict
larry	larry
copenhaga	copenhagen
lipsește	missing
roland	roland
trepte	footsteps
trepte	steps
conservarea	conservation
conservarea	preservation
mahmud	mahmud
pictată	painted
progresul	progress
ciclu	cycle
rundă	round
emanuel	emanuel
reforme	reforms
junior	junior
platon	plato
arhivele	archives
metrou	subway
metrou	metro
vendée	vendée
vicar	vicar
einstein	einstein
prelucrarea	processing
sclavi	slaves
wrestling	wrestling
nasr	nasr
merit	merit
perspectivă	perspective
zalău	zalău
singular	singular
recenzie	review
pierdută	lost
stewart	stewart
trimisă	sent
aveyron	aveyron
obținută	obtained
adâncimea	depth
chelsea	chelsea
unire	merge
unire	bonding
întâlnirea	meeting
panzer	panzer
cursa	race
doctoratul	doctorate
catalogul	catalog
catalogul	catalogue
publicitate	advertising
vânt	wind
blocarea	blocking
obiectivul	objective
regilor	kings
spirituale	spiritual
ing	ing
elevii	students
elevii	pupils
determinarea	determination
frumoasa	beautiful
mobilă	mobile
mobilă	furniture
potter	potter
corina	corina
anonim	anonymous
plumb	lead
localizat	located
localizat	localised
kır	kır
side	side
toplam	toplam
efortul	effort
manieră	manner
navală	naval
cartoon	cartoon
pânză	canvas
necunoscută	unknown
doctrina	doctrine
senatul	senate
concentrat	concentrated
concentrat	concentrate
concentrat	focused
săli	halls
stars	stars
lipsesc	missing
catalog	catalog
catalog	catalogue
diesel	diesel
toronto	toronto
darwin	darwin
teolog	theologian
rey	rey
cadre	frames
cadre	frameworks
așteptat	expected
așteptat	waited
copie	copy
augusta	augusta
conservatorul	conservatory
nièvre	nièvre
individ	individual
cauze	causes
posturi	posts
confluența	confluence
rosa	rosa
neil	neil
orientale	oriental
murray	murray
giorgio	giorgio
bloc	block
extremă	extreme
sophie	sophie
fundamentală	fundamental
democratice	democratic
searchbuttonlabel	searchbuttonlabel
verii	cousins
aventură	adventure
ciot	stub
ciot	stump
gri	gray
gri	grey
imdb	imdb
producători	producers
producători	manufacturers
editată	edited
gratuit	free
proiectele	projects
versailles	versailles
floarea	flower
terry	terry
nordice	nordic
desemnează	designates
desemnează	designate
viziune	vision
partidele	parties
catalonia	catalonia
profesie	profession
mayenne	mayenne
tablouri	paintings
dean	dean
zagreb	zagreb
exemplul	example
incintă	enclosure
magnolia	magnolia
informare	briefing
populații	populations
bere	beer
solicitat	requested
mandatul	warrant
mandatul	mandate
cape	cape
expert	expert
zahăr	sucrose
zahăr	sugar
wagner	wagner
călugăr	monk
titu	titu
scandal	scandal
digitală	digital
mențiune	term
fals	false
fals	fake
ruta	route
clement	clément
clement	clement
liberi	free
arhiducele	archduke
amintirea	memory
medicamente	drugs
medicamente	medicines
întrebat	asked
stări	states
stări	moods
colaborator	collaborator
colaborator	contributor
auf	auf
opiniile	opinions
lunar	monthly
lunar	lunar
omenirii	mankind
celulele	cells
percuție	percussion
short	short
depășește	exceeds
baron	baron
suficientă	sufficient
atelier	workshop
botanophila	botanophila
barry	barry
mercur	mercury
tun	cannon
tun	tun
păr	hair
cresc	grow
concluzie	conclusion
admis	admitted
astrofizică	astrophysics
egalitate	equality
domnit	reigned
identificare	identification
astronomic	astronomical
demonstrează	demonstrate
ideal	ideal
ungureanu	ungureanu
găsită	found
haine	clothes
structurii	structure
abdallah	abdallah
repetat	repeated
repetat	repeatedly
tinere	young
romaniansoccer	romaniansoccer
gros	thick
calendar	calendar
patrimoniu	heritage
vocale	vowels
vocale	vocal
donat	donated
dakota	dakota
valle	valle
mansur	mansur
susan	susan
holt	holt
federală	federal
pont	pont
pont	tip
înlocuirea	replacing
înlocuirea	replacement
apple	apple
nepenthes	nepenthes
dame	checkers
dame	dame
strasbourg	strasbourg
sportivi	athletes
tulburări	disorders
apostoli	apostles
château	château
adăugarea	addition
adăugarea	adding
bois	bois
formularul	form
grupate	grouped
crimă	murder
crimă	crime
gotic	gothic
tre	tre
roz	pink
ahmed	ahmed
latine	latin
frunzele	leaves
exprima	express
compoziții	compositions
moscovei	moscow
kashmir	kashmir
belgian	belgian
parohială	parochial
wikimapia	wikimapia
orange	orange
pierderile	losses
naviga	sail
echipament	equipment
includerea	inclusion
simona	simona
joachim	joachim
formal	formally
formal	formal
austin	austin
filozofia	philosophy
aedes	aedes
implicarea	involvement
explica	explain
wall	wall
harald	harald
meridiane	meridians
autonome	autonomous
village	village
răspândirea	spreading
răspândirea	spread
intensă	intense
lugoj	lugoj
mutată	moved
strâmtoarea	strait
refugiat	refugee
ungară	hungarian
scăzută	low
compune	compose
exterioară	exterior
ofensivă	offensive
intervenție	intervention
galilor	gauls
fenomene	phenomena
austrieci	austrians
austrieci	austrian
costume	costumes
costume	suits
muban	muban
cânta	sing
grija	caring
grija	care
corul	choir
corul	chorus
modelele	models
îndeplini	fulfill
reich	reich
józsef	józsef
agricol	agricultural
originile	origins
khan	khan
mutarea	moving
moscheea	mosque
lățimea	width
ladislau	ladislaus
cooper	cooper
preah	preah
invazie	invasion
ehf	ehf
brabant	brabant
dealuri	hills
danny	danny
determinată	determined
tag	tag
perete	wall
amenajare	fitting
nicholas	nicholas
ixodes	ixodes
istoricii	historians
străină	foreign
iubit	loved
iubit	beloved
iubit	boyfriend
entitate	entity
platină	platinum
rezolva	solve
indivizi	individuals
continental	continental
caesar	caesar
cruci	crosses
maiorescu	maiorescu
conferit	conferred
pcupdate	pcupdate
pierdute	lost
ctenus	ctenus
perioadele	periods
bianco	bianco
ilustrează	illustrates
ilustrează	illustrate
cardinal	cardinal
clare	clare
vulcan	volcano
vulcan	vulcan
moștenit	inherited
curentului	current
destinație	destination
hawaii	hawaii
sunetul	sound
xbox	xbox
inca	still
gama	gamma
baby	baby
evaluarea	valuation
evaluarea	assessment
evaluarea	evaluation
cinematografie	cinematography
danez	danish
raportat	reported
râurilor	rivers
paula	paula
acoperiș	rooftop
acoperiș	roof
conferință	conference
iasi	iasi
legală	legal
civili	civilians
calliphoridae	calliphoridae
elisabeth	elisabeth
citește	read
variate	varied
bros	bros
prăbușit	crashed
prăbușit	collapsed
clasificate	classified
clasificate	classifieds
pic	pic
administrare	administration
cereale	grain
cereale	cereals
cereale	cereal
warren	warren
parlamentară	parliamentary
ferenc	ferenc
pictori	painters
stein	stein
basel	basel
doo	doo
étienne	étienne
trafic	traffic
baraj	dam
absolvent	graduate
islamică	islamic
derivă	drift
derivă	drifting
balta	pond
balta	puddle
aires	aires
roberts	roberts
kingdom	kingdom
amândoi	both
statuie	statue
tennessee	tennessee
toamnă	autumn
moștenirea	legacy
moștenirea	inheritance
oslo	oslo
turner	turner
adăugate	added
bucegi	bucegi
beta	beta
gherla	gherla
aripi	wings
golf	golf
interzisă	forbidden
interzisă	prohibited
numirea	appointment
contactul	contact
java	java
alexandre	alexandre
siberia	siberia
inspector	inspector
cumva	somehow
ocean	ocean
claudia	claudia
plăcut	liked
plăcut	pleasant
evans	evans
franceza	french
wien	wien
edge	edge
declarație	statement
declarație	declaration
conferă	confer
conferă	confers
discursul	speech
alabama	alabama
folosire	usage
intrând	entering
tabel	table
indiei	india
keith	keith
asigurată	insured
corrèze	corrèze
emise	issued
campionatele	championships
manastirea	monastery
louisiana	louisiana
baschet	basketball
organ	organ
hotelul	hotel
oarecum	somewhat
finistère	finistère
tranziție	transition
distanțe	distances
cald	hot
cald	warm
adânc	deep
salvare	salvation
salvare	rescue
vacanță	holiday
vacanță	vacation
malta	malta
manifestări	manifestations
fotbalul	football
radical	radical
asalt	assault
renault	renault
sierra	sierra
specializate	specialised
specializate	specialized
buenos	buenos
stelian	stelian
dificultăți	difficulty
dificultăți	difficulties
râurile	rivers
tribuna	tribune
lapte	milk
grove	grove
memoriile	memoirs
memoriile	memoir
viteze	speeds
studios	studios
clara	clara
vieți	lives
boemia	bohemia
oferind	boasting
oferind	offering
letonia	latvia
islanda	iceland
hanovra	hanover
hanovra	hannover
rahman	rahman
edinburgh	edinburgh
hlist	hlist
silva	silva
democratic	democratically
democratic	democratic
distinge	distinguish
chalukya	chalukya
vrei	want
strategice	strategic
utilizând	using
numeric	numeric
simte	feel
lloyd	lloyd
robinson	robinson
oldenburg	oldenburg
controverse	controversy
lunile	months
rase	races
rase	breeds
bordeaux	bordeaux
lecții	lessons
jay	jay
soră	sister
teste	tests
aventuri	adventures
aventuri	adventure
autorități	authorities
estimare	estimate
estimare	estimation
comparativ	comparative
comparativ	comparatively
comparativ	compared
islamice	islamic
salt	jump
salt	salt
bălcescu	bălcescu
dezvolta	develop
tensiune	tension
tensiune	voltage
banda	tape
lycosa	lycosa
batman	batman
pius	pius
trăiască	live
exprimate	cast
exprimate	expressed
moneda	currency
moneda	coin
instalații	installations
romeo	romeo
concomitent	concomitant
aruncă	throw
conservare	conservation
conservare	preservation
matilda	matilda
recentă	recent
accentul	accent
trenul	train
philodromus	philodromus
bate	beat
bate	beats
propuse	proposed
manuscris	manuscript
tanc	tank
veliko	veliko
zguduit	shaken
zguduit	rocked
zguduit	shook
bolnav	sick
prix	prix
teodorescu	teodorescu
nguyen	nguyen
afectează	affects
afectează	affect
fiice	daughters
nigeria	nigeria
gust	taste
gilbert	gilbert
vizuale	visuals
minnesota	minnesota
allah	allah
joan	joan
latina	latin
latina	latina
dysdera	dysdera
vila	vila
vila	villa
bor	bor
bor	boron
muncitori	workers
györgy	györgy
gabrovo	gabrovo
strategic	strategically
strategic	strategic
privit	watched
dennis	dennis
geografia	geography
miami	miami
lang	lang
multumesc	thanks
bugetul	budget
matthew	matthew
intervalul	range
intervalul	interval
wisconsin	wisconsin
străzile	streets
sunete	sounds
cablu	cable
barajul	dam
autonom	autonomous
lucas	lucas
justin	justin
laurent	laurent
lingvistice	linguistic
northern	northern
zaharia	zechariah
astea	these
procedura	procedure
caussols	caussols
marx	marx
lector	lecturer
primăvară	spring
aprox	approx
gândirea	thinking
esențial	essential
consecutive	consecutive
navarra	navarre
asimov	asimov
carnivore	carnivores
carnivore	carnivorous
repere	highlights
repere	landmarks
repere	milestones
cifră	digit
singapore	singapore
interpreta	interpret
acoperire	coating
acoperire	cover
acoperire	coverage
fontsize	fontsize
wells	wells
pasăre	bird
ocazional	occasional
ocazional	occasionally
dedesubt	underneath
dedesubt	below
atei	atheists
fundul	butt
stadiul	stage
transforma	transform
grădină	garden
springs	springs
detaliate	detailed
estimat	estimated
derivate	derivatives
derivate	derived
derivate	derivative
liban	lebanon
scaune	chairs
scaune	seats
gov	gov
béla	béla
regii	kings
apărând	appearing
apărând	defending
emma	emma
persană	persian
doyle	doyle
efectuarea	making
efectuarea	performing
organe	organs
organe	organ
surori	sisters
goethe	goethe
cazimir	casimir
aug	aug
eforturi	efforts
kogălniceanu	kogălniceanu
bobby	bobby
ring	ring
sever	severe
sever	sever
faze	phases
pielea	skin
abordare	approach
vorbind	speaking
apărat	defended
bretagne	bretagne
mina	mina
pactului	pact
cameron	cameron
revistele	magazines
decisiv	decisive
sălbatice	wild
noroc	cheers
definiția	definition
stins	extinguished
stins	faded
averea	wealth
practicat	practiced
dați	give
țintă	target
comunitățile	communities
nenumărate	countless
vânzare	sale
cunoștință	acquaintance
vărul	cousin
mer	mer
automată	automatic
refugiați	refugees
fereastră	window
rector	rector
propagandă	propaganda
dominat	dominated
crească	grow
rebel	rebel
ccd	ccd
lanțul	chain
uruguay	uruguay
pascal	pascal
mecanica	mechanics
abbasid	abbasid
iugoslaviei	yugoslavia
damian	damian
roll	roll
preluarea	fetching
preluarea	takeover
coadă	queue
coadă	tail
judecător	judge
semnează	sign
palermo	palermo
hugh	hugh
termică	thermal
laos	laos
argumentele	arguments
alexandrescu	alexandrescu
uesac	uesac
fir	wire
fir	thread
legiunea	legion
chip	chip
prefect	prefect
coroană	wreath
coroană	crown
localizată	located
localizată	localised
triburile	tribes
mon	mon
lisa	lisa
platoul	plateau
jpg}}	jpg}}
păsările	birds
arcul	bow
square	square
doc	doc
încet	slowly
call	call
cerul	sky
esențiale	essential
transferul	transfer
creatorul	creator
companiile	companies
silvia	silvia
silvia	sylvia
gibson	gibson
înconjurată	surrounded
viktor	viktor
babeș	babeș
adulți	adults
adulți	adult
nivele	tiers
nivele	levels
estadio	estadio
copertă	cover
atribuită	attributed
atribuită	assigned
wood	wood
abc	abc
iordache	iordache
geo	geo
coordonatele	coordinates
johan	johan
santos	santos
gif	gif
armament	armament
armament	weaponry
armament	armaments
credit	credit
simfonia	symphony
marcând	scoring
visul	dream
eddie	eddie
întreprinderi	enterprises
mir	mir
entități	entities
pescuit	fisheries
pescuit	fishing
proporție	proportion
opoziția	opposition
jorge	jorge
frecvența	frequency
atribuite	attributed
atribuite	assigned
bursă	fellowship
bursă	scholarship
etaje	floors
rază	radius
dragomir	dragomir
reciproc	mutual
extra	extra
avansate	advanced
trenuri	trains
tratarea	treating
antena	dish
antena	antenna
umbra	shadow
umbra	shade
vocală	vowel
creuse	creuse
omorât	murdered
omorât	killed
mărturii	testimonials
mărturii	testimonies
mărturii	testimony
aaron	aaron
falls	falls
figură	figure
paraná	paraná
transformare	transformation
academică	academic
promovează	promote
promovează	boost
digitale	digital
abbas	abbas
hcm	hcm
grafic	graph
grafic	graphic
grafic	chart
antrenori	coaches
antrenori	trainers
contul	account
pedeapsa	penalty
pedeapsa	punishment
bancă	bank
bancă	bench
mei	mei
sevilla	sevilla
sevilla	seville
domnule	sir
definite	defined
pauză	pause
pauză	break
allan	allan
seminarul	seminar
săptămâna	week
globală	global
torre	torre
conan	conan
brescia	brescia
sarcini	tasks
circuitul	circuit
înfrânt	defeated
hrușciov	khrushchev
roxana	roxana
ferrara	ferrara
string	string
julian	julian
mandatului	mandate
collins	collins
ontario	ontario
valoroase	valuable
manifestat	manifested
pianist	pianist
viet	viet
reclamă	commercial
reclamă	advertising
reclamă	ad
maniu	maniu
merite	merits
merite	merit
tong	tong
neagu	neagu
comunicații	communications
junimea	junimea
manga	manga
electorală	electoral
indo	indo
marketing	marketing
declara	declare
montreal	montreal
ribbentrop	ribbentrop
scade	decrease
ton	tuna
ton	tone
cheia	key
britannica	britannica
romanov	romanov
vidin	vidin
mecanice	mechanical
vrh	vrh
hogna	hogna
ascunde	hide
mobil	mobile
sean	sean
schi	ski
schi	skiing
fondarea	founding
depozite	warehouses
depozite	deposits
fictiv	fictitious
fictiv	fictional
maplandia	maplandia
aeroport	airport
talentul	talent
oklahoma	oklahoma
terestră	terrestrial
permisiunea	permission
bernhard	bernhard
nepoata	granddaughter
nepoata	niece
bătut	beaten
pragul	threshold
ouă	eggs
ușa	door
aristotel	aristotle
panchen	panchen
lucilia	lucilia
octav	octav
alpha	alpha
firmă	firm
atlético	atlético
liudmila	lyudmila
contrar	contrary
sprijină	supports
tipărită	printed
rica	rica
araneidae	araneidae
imnul	anthem
chirurgie	surgery
afecta	affect
madison	madison
icoana	icon
xinglong	xinglong
amy	amy
klaus	klaus
adriana	adriana
pași	steps
spațial	spatial
legislația	legislation
butler	butler
discutat	discussed
inutil	pointless
inutil	useless
rolling	rolling
explicație	explanation
ritm	rhythm
hudson	hudson
placa	plaque
bursa	bursa
bursa	scholarship
nori	clouds
edmund	edmund
mercedes	mercedes
intelectuali	intellectuals
intelectuali	intellectual
împotrivă	against
proprietari	owners
protejat	protected
ronald	ronald
alin	alin
colective	collective
popularitate	popularity
gândit	thought
homo	homo
homo	gay
castle	castle
droguri	drugs
droguri	dope
droguri	drug
willem	willem
execuție	execution
jucând	playing
intervenit	intervened
generat	generated
succese	successes
succese	success
bratislava	bratislava
damasc	damascus
nuvelă	novel
nuvelă	novella
morbihan	morbihan
publica	publish
card	card
reformei	reform
necunoscute	unknown
filipine	philippines
secundară	secondary
carabus	carabus
promis	promised
rin	rin
rin	rhine
incident	incident
semnificația	significance
plecare	departure
memorii	memoirs
memorii	memoir
gândire	thinking
identificate	identified
vladimirescu	vladimirescu
anatomia	anatomy
farmacie	drugstore
farmacie	pharmacy
biți	bits
rightarm	rightarm
mexican	mexican
five	five
portrete	portraits
pictate	painted
aleksandr	aleksandr
parcuri	parks
pozitivă	positive
tipărit	printed
sângele	blood
marchiz	marquess
marchiz	marquis
yemen	yemen
cântând	singing
stiluri	styles
protejarea	protecting
norvegian	norwegian
împușcat	shot
sălbatică	wild
teamă	fear
statui	statues
sâmbătă	saturday
profesioniști	professionals
irlandez	irish
consilieri	advisers
consilieri	advisors
consilieri	counselors
bunica	grandmother
bunica	granny
bunica	grandma
lituaniei	lithuania
limitate	limited
pereți	walls
sándor	sándor
cosmin	cosmin
perry	perry
sept	septum
sept	sept
distincție	distinction
platformă	platform
platformă	backend
cronici	chronicles
rugăciune	prayer
luther	luther
personalitatea	personality
atelierul	workshop
cook	cook
tighina	tighina
tara	country
tara	tara
blois	blois
abur	steam
oleg	oleg
respectarea	compliance
vama	customs
interimar	interim
adult	adult
împarte	split
experimental	experimental
dir	dir
logica	logic
helsinki	helsinki
julia	julia
mussolini	mussolini
scooby	scooby
faimos	famous
nuntă	wedding
magdalena	magdalena
anastasia	anastasia
studiourile	studios
posterior	posterior
bat	bat
apr	apr
mintea	mind
dmitri	dmitry
dmitri	dmitri
americanii	americans
alexei	alexei
sârb	serb
sârb	serbian
documentul	document
baba	baba
manolescu	manolescu
mediaș	mediaș
codreanu	codreanu
preocupat	concerned
preocupat	preoccupied
brusc	suddenly
brusc	sudden
debehogne	debehogne
japonezi	japanese
inspirată	inspired
paraguay	paraguay
consacrat	consecrated
jennifer	jennifer
facto	facto
cantal	cantal
izolat	insulated
izolat	isolated
berg	berg
anulat	cancelled
anulat	canceled
precizează	specify
evaluare	rating
evaluare	evaluation
evaluare	assessment
evaluare	valuation
asediu	siege
divizat	divided
divizat	split
bergamo	bergamo
taxe	taxes
taxe	fees
novo	novo
încurajat	encouraged
enterprise	enterprise
inamic	enemy
vehicul	vehicle
botanică	botany
botanică	botanical
arma	weapon
arma	gun
diferențele	differences
servi	serve
hanul	inn
presupus	assumed
presupus	supposedly
presupus	alleged
presupus	presumed
nagy	nagy
musulmane	muslim
modificată	modified
modificată	amended
arakan	arakan
definitivă	definitive
rasa	breed
rasa	race
restaurarea	restoration
emerit	emeritus
cafenea	cafe
cafenea	café
permanente	permanent
vizibilă	visible
asociație	association
index	index
obișnuită	ordinary
moral	morally
moral	moral
kenneth	kenneth
trofee	trophies
asigurări	insurance
dispute	disputes
portughez	portuguese
brâncuși	brâncuși
funcționar	clerk
haiti	haiti
sindromul	syndrome
locație	location
prezență	attendance
prezență	presence
eugene	eugene
cândva	sometime
persan	persian
sinaia	sinaia
traseu	trail
traseu	route
îmbunătățit	improved
îmbunătățit	enhanced
vinde	sell
atlantique	atlantique
arhitecturale	architectural
logic	logical
logic	logic
precizie	precision
precizie	accuracy
meyer	meyer
măsoară	measure
dom	dome
dom	dom
über	über
fame	fame
lymantria	lymantria
controlat	controlled
acționat	acted
coleg	colleague
coleg	coworker
express	express
amt	amt
nel	nel
baltice	baltic
mustafa	mustafa
ardere	combustion
ardere	burning
cost	cost
modifică	modify
boeing	boeing
întoarcere	return
cercetătorii	researchers
peșteră	cave
senat	senate
gay	gays
gay	gay
creta	crete
creta	chalk
ming	ming
montgomery	montgomery
egiptean	egyptian
variabile	variable
variabile	variables
mediterană	mediterranean
metale	metal
metale	metals
pană	feather
bush	bush
standardele	standards
daneză	danish
verticală	vertical
renunță	cancel
azerbaidjan	azerbaijan
niveluri	tiers
niveluri	levels
mitchell	mitchell
mantova	mantova
notat	noted
strategică	strategic
cambodgia	cambodian
cambodgia	cambodia
pablo	pablo
morris	morris
lent	slow
cosma	cosma
prevăzută	foreseen
academice	academic
ice	ice
kate	kate
aurora	aurora
sinod	synod
rou	rou
maría	maría
oregon	oregon
bănci	banks
bănci	benches
restaurant	restaurant
afectate	affected
baltă	puddle
pavia	pavia
structurile	structures
impuse	imposed
silezia	silesian
silezia	silesia
uriaș	giant
tabere	camps
alma	alma
atribuie	assign
formulă	formula
kentucky	kentucky
indicat	indicated
mărfuri	cargo
mărfuri	goods
mărfuri	commodities
belle	belle
grâu	wheat
cuantică	quantum
văzute	seen
văzute	viewed
walt	walt
dublin	dublin
festivaluri	festivals
ball	ball
rusesc	russian
concepte	concepts
padova	padua
echivalentul	equivalent
fani	fans
afirmând	affirming
postum	posthumous
postum	posthumously
plovdiv	plovdiv
participanții	participants
mandate	warrants
mandate	mandates
morminte	tombs
morminte	graves
colegi	colleagues
colegi	coworkers
potențialul	potential
exactă	exact
horror	horror
vizibile	visible
uss	uss
cdep	cdep
flash	flash
duminica	sundays
duminica	sunday
srl	llc
srl	srl
srl	ltd
împiedicat	prevented
materia	matter
persia	persia
elementare	elementary
elementare	incremental
christina	christina
arhipelagul	archipelago
datorat	owed
succesiunea	succession
protocol	protocol
update	update
execută	execute
ecuador	ecuador
bull	bull
kenya	kenya
ntupdate	ntupdate
îngropat	buried
november	november
locații	locations
biblie	bible
fabricat	manufactured
fabricat	fabricated
durere	pain
întâlniri	meetings
întâlniri	encounters
recomandat	recommended
lucrând	working
taiwan	taiwan
dramatică	dramatic
populată	populated
tereza	teresa
tereza	theresa
culex	culex
semifinale	semis
semifinale	semifinals
dex	dex
semnată	signed
baptiste	baptiste
stelele	stars
emisă	issued
emisă	emitted
compuși	compounds
sovieticii	soviets
praf	dust
praf	powder
haga	hague
zeus	zeus
animat	toon
animat	animated
nintendo	nintendo
locuită	inhabited
semnal	signal
ceas	watch
ceas	clock
democrație	democracy
alfa	alpha
alfa	alfa
expune	expose
fantastică	fantastic
partener	partner
cerințele	requirements
occidentali	westerners
amenințare	threat
inventator	inventor
bolta	vault
lovituri	kicks
lovituri	blows
lovituri	dents
vizitează	visit
vizibil	visible
rgb	rgb
sporturi	sports
informatii	info
informatii	information
observație	remark
observație	observation
parker	parker
zeilor	gods
liechtenstein	liechtenstein
discovery	discovery
găsiți	find
dur	rough
dur	tough
tăiat	cut
etajul	floor
chapelle	chapelle
chapelle	chappelle
strategie	strategy
peisaj	landscape
attila	attila
experiment	experiment
finalizată	completed
vinci	vinci
reptile	reptile
reptile	reptiles
constat	consisted
convinge	convince
convinge	persuade
sportul	sport
leul	lion
personalul	personnel
personalul	staff
aron	aron
preveni	prevent
plată	payment
prize	sockets
won	won
integrarea	integration
reci	cold
integrat	integrated
fabricate	manufactured
fabricate	fabricated
roosevelt	roosevelt
nuvela	novella
vasili	vasily
aviație	aviation
spanioli	spaniards
spanioli	spanish
heinz	heinz
petit	petit
thompson	thompson
wallace	wallace
monarh	monarch
beethoven	beethoven
ploaie	rain
islamului	islam
bremen	bremen
zagora	zagora
artificial	artificially
artificial	artificial
solară	solar
disponibilă	available
reprezentative	representative
marino	marino
fetele	girls
primită	received
guvernat	governed
strategia	strategy
transmise	transmitted
culmea	ridge
identice	identical
fotografia	photo
fotografia	photography
locuite	inhabited
albrecht	albrecht
aia	that
separarea	separation
datoria	duty
interpretări	interpretations
scrisoarea	letter
eroul	hero
aviației	aviation
rupt	broken
rupt	ripped
integrate	integrated
panama	panama
nichita	nichita
afc	afc
utilizări	uses
greaca	greek
supranumit	nicknamed
nancy	nancy
comisie	commission
reveni	revert
westfalia	westphalia
arkansas	arkansas
